d00mmm0mmm
0m00000m00
00mm0m000m
m000mmm0mm
000m00m00m
mm0mmm00mm
000mmmm0mm
0m000mm00m
0mm0m000mm
m0000m000a
