dmmm00000m
00mm0mmm00
m0mm0000m0
m000m0m0m0
00mmm0m0m0
0mm000m0m0
0mmmmm00m0
0m00000m00
000mmmmm0m
0mma000000
