d00mmmmm0m00mmm
mm00000m0mm0m00
00mm0m000m0000m
m00m000m00000ma
000mm0mmmmmmm0m
mm000000m000mmm
000mmmm000m00mm
0m000mmmmmm000m
0mm0m0000m00mmm
mmm00m0m0mm00mm
mmm0mm0m00mm00m
m000m00m0m000m0
000000m00mmm000
mmmm00m00000mmm
a000m0mm000000a

